0
195477504
377602048
537657344
694173696
846020608
995770368
1141227520
1270644736
1395245056
1525940224
1648033792
1768177664
1888600064
2013511680
2117566464
2215788544
2310782976
2401501184
2462941184
2633973760
2725724160
2725740544
2725920768
2726166528
2726330368
2726379520
2726461440
2726641664
2726854656
2727198720
2727247872
2727477248
2727673856
2727706624
2727739392
2727788544
2727837696
2727870464
2727903232
2727936000
2727968768
2728050688
2728083456
2728116224
2728165376
2728214528
2728247296
2728280064
2728312832
2728345600
2728411136
2728443904
2728476672
2728493056
2728706048
2728902656
2728919040
2729132032
2729345024
2729541632
2730508288
2730704896
2730967040
2731130880
2731294720
2731409408
